111111
11E101
1C1011
100P01
111111