11111111111111111111111111111
10000000000000000000010000001
100000011111000000000100000C1
1P01000000E00000000C010000001
10010000000001000000000000001
10010000000001000000000000011
10010000000001000000000000011
100100000C0001000C00000001111
11111111111111111111111111111