1111111
1110001
1110001
11100P1
1111111